X X X I X
X A A A A
X X A A X
X A A X X
X B A X X