I A A A I
A A A A I
A I B A A
A A A A A
I A I A A