I A A A A A A A A A
A A A A A A A I A A  
A A A A A A A A A A  
A A A A A A I A A A  
I A A A B A A A A A  
A A A A A A A I A A  
A A A A A A A A A A  
A A I A A A A A A A  
A A A A A A A A A A  
A A A A A A A A A I  